###############################################
#     iiiiiiiiiiiiiiiiiiiiiiiiiiiiiiiiiiii    #
#  i              ¤       i                   #
#                             i     i         #
#       i               i                     #
#                  k                          #
#   i                     i         i         #
#¤                                           ¤#
###############################################
