###############################################
#                                             #
#                 ¤                           #
#                                             #
#                                             #
#                                             #
#                                             #
#¤                                           ¤#
###############################################
