###############################################
#                                             #
#  #  #  ###   ####   #### #  #  #   #  #     #
#  # #  #   #  #   #  #    # #   #   #  #     #
#  ##   #   #  #   #  #### ##    #   #  #     #
#  # #  #   #  #   #  #    # #   #   #  #     #
#  #  #  ###   ####   #### #  #   ###   ####  #
#                                             #
###############################################
